00000000000010011100
00000000000010000110
00000000000110001100
00000000001110000000
00000000000000000000
11000000000000000011
00000000000000000000
00000000000000000000
00000000000000010000
00000000000000011110
00000000000110001100
00000000100000000100
00000000100000011111
00000001100000000100
00000000111000000000
00000000000000000000
00000000000000000000
00000000000000000000
00000000000000000000
00000000000000000000